filename, language, JavaScript, JSON, Markdown, comment, blank, total
/home/cjw/dev/code/Ylink-server/.eslintrc.js, JavaScript, 7, 0, 0, 0, 1, 8
/home/cjw/dev/code/Ylink-server/.prettierrc.js, JavaScript, 6, 0, 0, 0, 1, 7
/home/cjw/dev/code/Ylink-server/README.md, Markdown, 0, 0, 2, 0, 1, 3
/home/cjw/dev/code/Ylink-server/config/keys.js, JavaScript, 9, 0, 0, 5, 1, 15
/home/cjw/dev/code/Ylink-server/config/multer.js, JavaScript, 36, 0, 0, 0, 7, 43
/home/cjw/dev/code/Ylink-server/config/passport.js, JavaScript, 21, 0, 0, 1, 5, 27
/home/cjw/dev/code/Ylink-server/models/article.js, JavaScript, 38, 0, 0, 0, 3, 41
/home/cjw/dev/code/Ylink-server/models/comment.js, JavaScript, 28, 0, 0, 0, 3, 31
/home/cjw/dev/code/Ylink-server/models/plan.js, JavaScript, 16, 0, 0, 0, 3, 19
/home/cjw/dev/code/Ylink-server/models/post.js, JavaScript, 32, 0, 0, 0, 3, 35
/home/cjw/dev/code/Ylink-server/models/postComment.js, JavaScript, 23, 0, 0, 0, 3, 26
/home/cjw/dev/code/Ylink-server/models/topic.js, JavaScript, 20, 0, 0, 0, 3, 23
/home/cjw/dev/code/Ylink-server/models/user.js, JavaScript, 46, 0, 0, 4, 3, 53
/home/cjw/dev/code/Ylink-server/models/userPlan.js, JavaScript, 14, 0, 0, 0, 3, 17
/home/cjw/dev/code/Ylink-server/models/userPost.js, JavaScript, 24, 0, 0, 2, 3, 29
/home/cjw/dev/code/Ylink-server/models/word.js, JavaScript, 27, 0, 0, 0, 3, 30
/home/cjw/dev/code/Ylink-server/models/wordbook.js, JavaScript, 12, 0, 0, 0, 3, 15
/home/cjw/dev/code/Ylink-server/package-lock.json, JSON, 0, 1438, 0, 0, 1, 1439
/home/cjw/dev/code/Ylink-server/package.json, JSON, 0, 32, 0, 0, 1, 33
/home/cjw/dev/code/Ylink-server/routes/api/article.js, JavaScript, 247, 0, 0, 45, 24, 316
/home/cjw/dev/code/Ylink-server/routes/api/plan.js, JavaScript, 249, 0, 0, 29, 15, 293
/home/cjw/dev/code/Ylink-server/routes/api/post.js, JavaScript, 355, 0, 0, 36, 25, 416
/home/cjw/dev/code/Ylink-server/routes/api/test.js, JavaScript, 92, 0, 0, 6, 6, 104
/home/cjw/dev/code/Ylink-server/routes/api/topic.js, JavaScript, 27, 0, 0, 4, 4, 35
/home/cjw/dev/code/Ylink-server/routes/api/translate.js, JavaScript, 45, 0, 0, 4, 4, 53
/home/cjw/dev/code/Ylink-server/routes/api/upload.js, JavaScript, 92, 0, 0, 3, 5, 100
/home/cjw/dev/code/Ylink-server/routes/api/user.js, JavaScript, 132, 0, 0, 30, 17, 179
/home/cjw/dev/code/Ylink-server/routes/api/word.js, JavaScript, 19, 0, 0, 4, 4, 27
/home/cjw/dev/code/Ylink-server/routes/api/wordbook.js, JavaScript, 106, 0, 0, 11, 7, 124
/home/cjw/dev/code/Ylink-server/server.js, JavaScript, 64, 0, 0, 4, 12, 80
/home/cjw/dev/code/Ylink-server/util/avatar.js, JavaScript, 10, 0, 0, 5, 4, 19
/home/cjw/dev/code/Ylink-server/util/random.js, JavaScript, 35, 0, 0, 4, 3, 42
/home/cjw/dev/code/Ylink-server/util/translation.js, JavaScript, 21, 0, 0, 0, 3, 24
/home/cjw/dev/code/Ylink-server/util/truncate.js, JavaScript, 5, 0, 0, 0, 1, 6
/home/cjw/dev/code/Ylink-server/validator/article.js, JavaScript, 20, 0, 0, 0, 7, 27
/home/cjw/dev/code/Ylink-server/validator/comment.js, JavaScript, 13, 0, 0, 0, 5, 18
/home/cjw/dev/code/Ylink-server/validator/is-empty.js, JavaScript, 6, 0, 0, 0, 2, 8
/home/cjw/dev/code/Ylink-server/validator/login.js, JavaScript, 20, 0, 0, 0, 7, 27
/home/cjw/dev/code/Ylink-server/validator/plan.js, JavaScript, 13, 0, 0, 0, 5, 18
/home/cjw/dev/code/Ylink-server/validator/post.js, JavaScript, 20, 0, 0, 0, 7, 27
/home/cjw/dev/code/Ylink-server/validator/register.js, JavaScript, 37, 0, 0, 0, 12, 49
Total, -, 1987, 1470, 2, 197, 230, 3886